0011110010
1000000010
1011000010
1000000000
1000000000
0011110001
1000000011
0000000010
1111100010
0000000010
